╔╦╦╦═══╦╦═══╦═╗
╠╩╩╝   ╚╝   ║ ║
║        ══ ║ ║
║ ║    ║    ║ ║
║ ║ ══ ╚╗     ║
║  ▒  ▒ ║  ╔═ ║
║      ║   ║  ║
╠╗   ║ ║     ═╣
╠╩═╗ ║        ║
║  ║    ═╗    ║
╠═       ║    ║
║ ▒       ═╗ ╔╣
║  ║  ══   ║ ╚╣
╠╗ ║       ║  ║
╚╩═╩═══════╩══╝
