╔════╦═══╦═══╦╗
║    ║   ║   ╚╣
║ ▒ ║      ╔═ ║
╠═  ║      ║  ║
║  ═╣  ▒  ▒   ║
║   ║ ║ ▒     ║
║  ▒  ║     ╔═╣
╠═          ║ ║
║ ══ ═══ ▒ ╔╝ ║
║          ║  ║
║           ══╣
║  ▒ ║ ╔═     ║
║    ║ ║ ▒ ══ ║
╠╗ ║   ║      ║
╚╩═╩═══╩══════╝
